const int N = 5;
int real_world_map[N][N] = {
{   00,	00,	00, 00, 99    },
{   00,	00,	00, 00, 00    },
{   99,	99,	00, 00, 99    },
{   00,	99,	00, 00, 99    },
{   00,	99,	00, 00, 99    }
};

const int N = 5;
int real_world_map[N][N] = {
{   00,	00,	00, 00, 99    },
{   00,	99,	99, 00, 00    },
{   00,	99,	00, 00, 99    },
{   99,	99,	99, 00, 99    },
{   00,	00,	00, 00, 99    }
};

const int N = 3;
int real_world_map[N][N] = {
{   00,	00,	00    },
{   99,	99,	99    },
{   00,	99,	00    }
};

const int N = 2;
int real_world_map[N][N] = {
{   00,	00    },
{   99,	99    }
};

const int N = 20;
int real_world_map[N][N] = {
{   00,	00,	00,	00,	99,	00,	00,	00,	00,	00,	00,	00,	00,	00,	99,	00,	00,	00,	00,	00  },
{   00,	00,	00,	00,	99,	00,	00,	00,	00,	00,	00,	00,	00,	00,	99,	00,	00,	00,	00,	00  },
{   00,	00,	00,	00,	99,	00,	00,	00,	00,	00,	00,	00,	00,	00,	99,	00,	00,	00,	00,	00  },
{   00,	00,	00,	00,	99,	00,	00,	00,	00,	00,	00,	00,	00,	00,	99,	00,	00,	00,	00,	00  },
{   00,	00,	00,	00,	99,	00,	00,	00,	00,	00,	00,	00,	00,	00,	99,	00,	00,	00,	00,	00  },
{   00,	00,	00,	00,	99,	00,	00,	00,	99,	99,	99,	99,	99,	99,	99,	00,	00,	99,	99,	99  },
{   00,	00,	00,	00,	00,	00,	00,	00,	00,	00,	00,	00,	00,	00,	00,	00,	00,	00,	00,	00  },
{   00,	00,	00,	00,	00,	00,	00,	00,	00,	00,	00,	00,	00,	00,	00,	00,	00,	00,	00,	00  },
{   00,	00,	00,	00,	00,	00,	00,	00,	00,	00,	00,	00,	00,	00,	99,	99,	99,	99,	00,	00  },
{   00,	00,	00,	00,	99,	00,	00,	00,	00,	00,	00,	00,	00,	00,	99,	99,	99,	99,	00,	00  },
{   99,	99,	00,	00,	99,	00,	00,	00,	00,	00,	00,	00,	00,	00,	99,	99,	99,	99,	00,	00  },
{   99,	99,	00,	00,	99,	00,	00,	00,	00,	00,	00,	00,	00,	00,	00,	00,	00,	00,	00,	00  },
{   99,	99,	00,	00,	99,	00,	00,	99,	99,	99,	99,	00,	00,	00,	00,	00,	00,	00,	00,	00  },
{   99,	99,	00,	00,	99,	00,	00,	99,	99,	99,	99,	00,	00,	00,	00,	00,	00,	00,	00,	00  },
{   00,	00,	00,	00,	99,	00,	00,	99,	99,	99,	99,	00,	00,	00,	00,	00,	00,	00,	00,	00  },
{   00,	00,	00,	00,	99,	00,	00,	00,	00,	00,	00,	00,	00,	00,	00,	00,	00,	00,	00,	00  },
{   00,	00,	00,	00,	99,	00,	00,	00,	00,	00,	00,	00,	00,	00,	00,	99,	99,	99,	99,	99  },
{   00,	00,	00,	00,	99,	00,	00,	00,	00,	00,	00,	00,	00,	00,	00,	99,	99,	99,	99,	99  },
{   00,	00,	00,	00,	99,	00,	00,	00,	00,	00,	00,	00,	00,	00,	00,	99,	99,	99,	99,	99  },
{   00,	00,	00,	00,	99,	00,	00,	00,	00,	00,	00,	00,	00,	00,	00,	99,	99,	99,	99,	99  }
};